aaaaaaaaaaaaaaaaa
ap  b b  b     la
a a a a a a aba a
a b   b bb      a
a a a a a a aba a
abb   b bb      a
a a a a a a aba a
a   bbb b  bb   a
a a a a a a aba a
a  b bbbxbbb    a
a a a a abababa a
a  bbbb bb     ba
aaaaaaaaaaaaaaaaa