aaaaaaaaaaaaaaaaa
ap  b b  b     la
a a a a a a aba a
a     b bb      a
a a a a a a aba a
a     b bb      a
a a a a a a aba a
a   bbb b  bb   a
a a a a a a aba a
a  b bbbbbbb    a
a a a a abababa a
a  bbbb bb     xa
aaaaaaaaaaaaaaaaa