aaaaaaaaaaaaaaaaa
ap  b b  b      a
a a a a a a a a a
a     b bb      a
a a a a a a a a a
a     b bb      a
a a a a a a a a a
a   bbb b  bb   a
a a a a a a a a a
a  b bbbbbbb    a
a a a a abababa a
a  bbbb bb     ga
aaaaaaaaaaaaaaaaa