aaaaaaaaaaaaaaaaa
ap              a
a a a a a a a a a
a               a
a a a a a a a a a
a               a
a a a a a a a a a
a               a
a a a a a a a a a
a               a
a a a a a a a a a
a              ga
aaaaaaaaaaaaaaaaa